# Stage1
..................................................
..................................................
...................S..............................
........E.......S...............^.....E...........
GGGGGGGGGGGPGGGGGGGGGGGGGGGGGGGGGGGGGGGGGGGGGGGGGG
# Stage2
..................................................
..................................................
..................................................
..................................................
GGGGGGGGGGGGGGGGGGGGGGGGGGGGGGGGGGGGGGGGGGGGGGGGGG
# Stage3
..................................................
..................................................
..................................................
..................................................
GGGGGGGGGGGGGGGGGGGGGGGGGGGGGGGGGGGGGGGGGGGGGGGGGG
# Stage4
..................................................
..................................................
..................................................
..................................................
GGGGGGGGGGGGGGGGGGGGGGGGGGGGGGGGGGGGGGGGGGGGGGGGGG
# Stage5
..................................................
..................................................
..................................................
..................................................
GGGGGGGGGGGGGGGGGGGGGGGGGGGGGGGGGGGGGGGGGGGGGGGGGG
# Stage6
..................................................
..................................................
..................................................
..................................................
GGGGGGGGGGGGGGGGGGGGGGGGGGGGGGGGGGGGGGGGGGGGGGGGGG
# Stage7
..................................................
..................................................
..................................................
..................................................
GGGGGGGGGGGGGGGGGGGGGGGGGGGGGGGGGGGGGGGGGGGGGGGGGG
# Stage8
..................................................
..................................................
..................................................
..................................................
GGGGGGGGGGGGGGGGGGGGGGGGGGGGGGGGGGGGGGGGGGGGGGGGGG
# Stage9
..................................................
..................................................
..................................................
..................................................
GGGGGGGGGGGGGGGGGGGGGGGGGGGGGGGGGGGGGGGGGGGGGGGGGG
# Stage10
..................................................
..................................................
..................................................
..................................................
GGGGGGGGGGGGGGGGGGGGGGGGGGGGGGGGGGGGGGGGGGGGGGGGGG

